id,Hit Point,Attack Point,Recovery,Total,Attribute
504,1200,800,300,2300,Dark
828,1708,859,823,3390,Earth
907,1259,651,251,2161,Light
775,896,397,48,1341,Dark
955,2545,1625,380,4550,Dark
1307,1614,2109,280,4003,Fire
658,7843,3177,1012,12032,Earth
798,2051,726,19,2796,Dark
1481,1139,637,231,2007,Water
104,135,79,79,293,Dark
673,250,150,300,700,Dark
270,100,100,10,210,Water
622,1811,724,99,2634,Water
469,1289,1992,307,3588,Fire
1310,4672,2309,515,7496,Dark
128,306,253,100,659,Dark
1370,3397,1324,265,4986,Dark
974,290,188,49,527,Dark
1116,1223,277,6,1506,Earth
1413,730,873,217,1820,Earth
488,463,549,151,1163,Earth
414,3208,1071,112,4391,Water
533,1788,940,211,2939,Fire
934,348,156,18,522,Dark
83,1573,363,10,1946,Light
655,2198,1244,303,3745,Dark
693,825,345,376,1546,Earth
651,3612,1105,31,4748,Water
620,24923,7976,1422,34321,Fire
678,2347,1312,377,4036,Fire
82,502,118,4,624,Light
173,420,185,44,649,Dark
548,747,240,33,1020,Earth
1381,3883,1637,168,5688,Water
1128,1802,2198,443,4443,Earth
390,684,1057,180,1921,Fire
306,273,221,107,601,Dark
1334,1698,2606,370,4674,Dark
1371,3482,1823,528,5833,Water
742,2775,1483,1027,5285,Fire
1458,1597,726,224,2547,Earth
363,1429,651,202,2282,Light
98,145,77,76,298,Fire
221,1170,369,11,1550,Water
1364,3132,1976,407,5515,Dark
116,313,230,108,651,Water
985,3097,1257,145,4499,Earth
480,2004,1102,381,3487,Water
891,1209,699,245,2153,Water
636,1095,1663,344,3102,Water
144,1317,813,245,2375,Dark
799,4272,1560,37,5869,Dark
741,1200,800,300,2300,Fire
1084,2739,1711,440,4890,Fire
986,1088,679,277,2044,Water
646,1054,580,206,1840,Water
1010,207,243,74,524,Earth
544,1330,1988,327,3645,Dark
1218,3754,1401,422,5577,Earth
305,1229,999,539,2767,Light
975,909,587,157,1653,Dark
1159,1315,1602,354,3271,Light
662,3014,938,22,3974,Fire
145,2119,1308,387,3814,Dark
1261,3017,1534,450,5001,Water
1306,1527,2205,246,3978,Fire
56,231,122,104,457,Water
521,363,191,102,656,Water
856,2059,1132,392,3583,Water
1238,1474,760,145,2379,Fire
1048,2771,1356,402,4529,Earth
718,1463,1953,426,3842,Earth
707,1367,625,275,2267,Fire
491,1626,933,400,2959,Water
102,143,67,87,297,Light
1282,1110,561,209,1880,Light
110,581,168,24,773,Earth
877,2839,1243,437,4519,Earth
133,2164,1190,418,3772,Water
714,1533,2163,426,4122,Light
171,1358,481,171,2010,Light
880,3790,1492,190,5472,Water
210,3096,1540,409,5045,Dark
583,1713,586,12,2311,Earth
885,913,949,153,2015,Earth
52,3635,994,30,4659,Light
729,1404,1871,391,3666,Fire
1315,2306,1681,549,4536,Dark
259,1000,300,80,1380,Light
523,382,204,90,676,Fire
1189,3360,1756,508,5624,Water
266,100,700,0,800,Fire
809,1517,792,201,2510,Dark
1499,3116,1673,298,5087,Fire
507,3564,1606,421,5591,Fire
679,2620,1528,440,4588,Fire
514,2696,986,329,4011,Light
922,2272,1270,372,3914,Fire
381,1000,300,80,1380,Earth
358,2806,1451,341,4598,Fire
952,1394,709,216,2319,Light
1122,2023,1620,180,3823,Fire
582,704,677,229,1610,Fire
896,2805,1358,440,4603,Earth
1212,1516,2272,404,4192,Water
1444,770,414,262,1446,Light
1388,3000,1712,387,5099,Dark
107,1116,410,57,1583,Water
371,1590,645,185,2420,Earth
156,1284,459,69,1812,Light
47,777,200,7,984,Earth
123,1162,660,339,2161,Earth
428,600,600,60,1260,Earth
839,451,251,64,766,Dark
31,1246,409,135,1790,Earth
1465,2134,1268,813,4215,Dark
1269,3136,1453,440,5029,Light
151,2471,970,21,3462,Fire
115,1092,449,53,1594,Dark
322,834,466,142,1442,Fire
1391,3527,1620,302,5449,Fire
1275,541,275,107,923,Dark
594,3102,1410,439,4951,Light
1143,3027,1365,428,4820,Light
899,1184,769,227,2180,Dark
1302,2367,1310,321,3998,Fire
126,1048,666,373,2087,Light
103,439,206,268,913,Light
463,1863,594,82,2539,Earth
216,3758,939,28,4725,Earth
1253,2638,1709,374,4721,Fire
861,993,626,440,2059,Water
1478,2830,1685,420,4935,Light
728,832,1027,217,2076,Fire
1158,2745,1138,158,4041,Earth
1451,3132,1436,437,5005,Earth
335,844,451,448,1743,Fire
862,1521,960,700,3181,Water
1384,5216,1208,37,6461,Earth
690,2428,1618,436,4482,Dark
397,1159,2321,330,3810,Dark
858,1760,1032,578,3370,Earth
560,1156,1970,343,3469,Dark
1483,1119,677,211,2007,Fire
695,699,412,372,1483,Dark
1386,4115,1493,183,5791,Light
1397,3453,1549,496,5498,Light
219,1305,746,177,2228,Dark
998,4057,2100,489,6646,Light
776,1259,1617,326,3202,Water
857,2166,1211,348,3725,Fire
765,2393,1560,431,4384,Dark
1215,2575,1464,375,4414,Fire
990,1266,640,268,2174,Earth
1341,1935,1279,895,4109,Water
365,1429,651,202,2282,Light
691,714,375,401,1490,Water
1113,599,166,3,768,Fire
1201,2629,1437,485,4551,Water
1245,2231,2407,305,4943,Dark
1194,1680,1080,1100,3860,Light
1199,365,365,365,1095,Water
689,2583,1370,485,4438,Light
520,3068,1001,129,4198,Earth
286,2315,1367,710,4392,Dark
1184,4918,1402,115,6435,Light
804,3167,1496,375,5038,Fire
822,3589,1340,543,5472,Light
581,959,632,185,1776,Water
825,3804,1329,487,5620,Earth
61,835,350,306,1491,Earth
808,3136,1302,433,4871,Light
944,3049,1634,414,5097,Light
1046,2495,1372,474,4341,Water
314,2822,826,46,3694,Earth
1015,330,552,126,1008,Dark
1040,2819,1533,265,4617,Dark
708,1503,538,289,2330,Earth
753,2531,1243,475,4249,Light
1241,3310,1365,367,5042,Earth
290,6840,1711,0,8551,Earth
471,1490,1854,342,3686,Earth
903,1218,763,209,2190,Fire
2,364,200,68,632,Water
1216,3304,1558,462,5324,Water
1285,1775,2328,292,4395,Dark
1260,1342,1871,280,3493,Dark
703,3451,1658,222,5331,Light
281,400,400,40,840,Fire
180,1526,620,70,2216,Fire
340,1815,519,11,2345,Fire
940,1976,1954,325,4255,Dark
1254,2103,1351,750,4204,Dark
1395,2338,2164,453,4955,Water
1179,2202,1017,395,3614,Light
1032,2880,1395,286,4561,Water
923,2295,1283,369,3947,Fire
291,600,600,60,1260,Dark
1492,2930,1667,386,4983,Fire
419,1661,520,52,2233,Light
68,187,100,137,424,Fire
1108,1698,2315,408,4421,Light
604,1308,717,162,2187,Dark
1235,2911,1203,104,4218,Dark
1289,2914,1366,542,4822,Light
553,930,1439,238,2607,Fire
244,100,30,10,140,Light
380,1000,300,80,1380,Fire
37,220,100,28,348,Dark
117,1005,716,363,2084,Water
1328,1809,2570,376,4755,Fire
1352,1802,2539,349,4690,Fire
576,300,150,50,500,Fire
612,2347,1312,377,4036,Fire
605,2541,1393,317,4251,Dark
53,657,238,7,902,Dark
475,1199,2042,313,3554,Dark
873,817,343,269,1429,Earth
450,3774,1921,542,6237,Water
1287,2704,1505,521,4730,Water
1105,887,1068,171,2126,Earth
1321,3492,1437,255,5184,Water
1293,2828,1580,424,4832,Fire
746,1238,752,247,2237,Water
1292,4310,1526,206,6042,Water
222,3608,1133,34,4775,Water
587,2442,1354,458,4254,Light
596,1336,652,176,2164,Water
264,100,100,0,200,Fire
201,1626,722,227,2575,Water
631,1886,674,101,2661,Light
278,200,200,20,420,Light
1002,4040,1754,400,6194,Fire
249,300,100,20,420,Light
859,2603,984,237,3824,Light
258,1000,300,80,1380,Earth
473,1381,1874,376,3631,Light
518,950,352,48,1350,Light
574,3697,1108,133,4938,Light
230,1615,953,689,3257,Dark
1086,4212,1458,186,5856,Earth
1065,2650,1640,352,4642,Dark
629,3304,1286,141,4731,Earth
650,1033,638,191,1862,Dark
183,1677,535,74,2286,Earth
1117,593,145,3,741,Light
297,293,216,102,611,Fire
413,1579,553,50,2182,Water
686,2479,1473,481,4433,Water
257,1000,300,80,1380,Fire
887,1458,664,206,2328,Light
338,786,464,467,1717,Dark
1149,904,453,116,1473,Fire
558,2698,1226,382,4306,Light
316,2543,836,52,3431,Light
814,2526,1138,363,4027,Light
283,400,400,40,840,Light
1470,2421,1161,371,3953,Light
399,1551,816,588,2955,Water
311,1570,566,24,2160,Fire
1204,2841,1300,504,4645,Light
869,971,689,408,2068,Dark
478,1669,826,664,3159,Earth
462,1695,689,78,2462,Fire
343,1689,561,12,2262,Dark
1006,179,264,79,522,Water
845,2563,1540,385,4488,Dark
441,2426,986,208,3620,Light
561,2535,1448,344,4327,Dark
393,1469,2117,360,3946,Earth
1351,1726,2470,418,4614,Water
967,928,534,169,1631,Water
1459,3221,1385,424,5030,Earth
805,1791,664,203,2658,Earth
919,2187,1350,410,3947,Dark
442,2282,1164,187,3633,Dark
621,891,356,48,1295,Water
641,3831,1569,161,5561,Water
1160,1726,1061,528,3315,Dark
296,1180,1066,527,2773,Water
1013,351,468,140,959,Light
902,2378,1349,452,4179,Water
980,1198,601,76,1875,Water
218,3101,1134,159,4394,Light
477,1518,959,630,3107,Fire
607,1065,595,181,1841,Fire
1311,2383,1527,601,4511,Water
383,1000,300,80,1380,Dark
984,1385,562,65,2012,Earth
1001,3840,1673,449,5962,Water
1087,3338,1474,473,5285,Light
106,503,182,26,711,Water
608,1169,512,190,1871,Earth
1054,1131,1602,323,3056,Light
1094,2527,1296,495,4318,Light
1448,1412,858,216,2486,Fire
1014,106,178,39,323,Dark
14,380,186,70,636,Light
987,2264,1410,576,4250,Water
1324,3698,1342,249,5289,Light
878,2882,1466,414,4762,Water
251,600,200,40,840,Water
66,178,94,155,427,Water
228,2698,1226,382,4306,Light
567,2776,820,106,3702,Fire
1500,2017,702,520,3239,Water
1005,3760,1803,416,5979,Dark
451,1064,528,372,1964,Water
188,435,202,21,658,Dark
1138,1402,726,170,2298,Fire
791,4553,1410,40,6003,Water
502,1200,800,300,2300,Earth
499,1218,660,70,1948,Dark
821,3565,1342,549,5456,Light
431,1491,687,703,2881,Light
698,1364,1651,346,3361,Earth
1482,2658,1487,540,4685,Water
1447,2785,1643,409,4837,Water
1101,773,1107,184,2064,Water
287,4057,1854,330,6241,Dark
125,326,213,110,649,Light
174,1277,568,155,2000,Dark
1441,740,446,255,1441,Water
1139,2853,1582,349,4784,Fire
647,1109,620,184,1913,Fire
367,1431,651,203,2285,Light
356,2806,1451,341,4598,Fire
1119,557,170,3,730,Dark
1337,2942,1868,330,5140,Fire
771,505,266,293,1064,Water
500,2370,1281,137,3788,Dark
1278,799,998,140,1937,Fire
455,1042,580,345,1967,Dark
416,3310,1125,97,4532,Fire
813,2804,1126,331,4261,Earth
206,3655,1291,412,5358,Earth
29,285,92,31,408,Earth
1057,2557,1406,511,4474,Water
968,312,182,48,542,Fire
870,1490,1056,648,3194,Dark
540,2573,1470,349,4392,Dark
1210,1462,2382,350,4194,Dark
1030,3038,1921,496,5455,Dark
1331,2620,2209,376,5205,Earth
131,419,230,78,727,Water
26,515,216,58,789,Fire
369,1342,768,181,2291,Dark
1202,2717,1526,406,4649,Fire
459,1407,652,273,2332,Light
770,1486,1922,344,3752,Dark
611,2231,1227,424,3882,Water
961,6735,3926,1033,11694,Water
75,544,321,448,1313,Dark
38,435,202,55,692,Dark
141,1402,689,273,2364,Light
584,1226,608,176,2010,Light
148,1971,799,104,2874,Water
292,100,1600,100,1800,Earth
589,1276,2176,379,3831,Dark
48,2056,502,14,2572,Earth
1031,1239,754,124,2117,Water
1061,3227,1361,364,4952,Earth
351,1229,1622,309,3160,Fire
1480,2344,1363,710,4417,Dark
1301,2279,1235,392,3906,Water
207,1694,673,232,2599,Light
1115,658,143,3,804,Earth
391,1267,2278,322,3867,Fire
229,521,308,266,1095,Dark
829,2265,3050,427,5742,Fire
547,680,278,31,989,Fire
1326,1735,2485,438,4658,Water
45,1870,583,14,2467,Fire
657,7199,3575,974,11748,Fire
1495,2221,1355,337,3913,Fire
1466,2781,1312,404,4497,Light
59,759,406,290,1455,Fire
1415,618,1042,215,1875,Dark
420,3373,1007,116,4496,Light
147,1233,493,67,1793,Water
182,514,170,21,705,Earth
848,2452,1672,364,4488,Fire
432,1198,601,76,1875,Water
653,3303,1066,141,4510,Earth
1354,1775,2421,431,4627,Light
403,1471,581,82,2134,Water
1375,3084,1655,483,5222,Water
860,2446,1162,213,3821,Dark
241,100,30,10,140,Water
212,2977,1219,155,4351,Water
246,300,100,20,420,Water
736,1200,800,300,2300,Fire
411,2264,1112,425,3801,Light
1322,3529,1530,201,5260,Fire
1487,2785,1501,530,4816,Water
168,1507,476,156,2139,Earth
262,800,300,2,1102,Water
1022,3102,1749,536,5387,Water
1112,1059,301,6,1366,Water
24,3199,979,78,4256,Water
63,752,354,336,1442,Light
1170,3039,1302,463,4804,Earth
387,100,900,0,1000,Dark
660,6824,3678,1007,11509,Dark
1227,2211,751,32,2994,Light
530,794,468,212,1474,Dark
709,1353,545,317,2215,Light
16,1960,963,374,3297,Light
674,2705,1452,755,4912,Dark
1312,2492,1610,532,4634,Fire
231,2340,738,22,3100,Water
989,2331,1507,523,4361,Fire
1266,1813,2302,386,4501,Water
1376,3179,1764,389,5332,Fire
375,1374,700,197,2271,Water
293,3974,1901,401,6276,Light
17,126,78,23,227,Dark
361,1344,769,182,2295,Dark
18,357,220,64,641,Dark
435,2616,1511,136,4263,Fire
1419,3221,1479,369,5069,Fire
225,1077,352,46,1475,Earth
1453,3022,1485,547,5054,Light
226,3323,1083,140,4546,Earth
1299,365,365,365,1095,Water
1114,1114,322,5,1441,Fire
920,1726,1797,371,3894,Dark
635,2898,1493,140,4531,Dark
1067,3874,1400,153,5427,Fire
566,2638,767,119,3524,Water
1288,1153,541,214,1908,Light
818,3307,1581,481,5369,Dark
511,3575,1123,80,4778,Water
426,600,600,60,1260,Water
308,1086,900,480,2466,Dark
39,960,443,121,1524,Dark
797,4713,1326,41,6080,Light
1445,724,489,236,1449,Dark
1368,3979,1108,267,5354,Earth
1177,2135,1219,295,3649,Fire
8,1980,1107,324,3411,Fire
580,3296,1506,269,5071,Dark
1389,2979,1723,387,5089,Dark
1489,4965,1604,44,6613,Dark
1233,1790,1001,562,3353,Earth
1356,3198,1799,440,5437,Water
953,2708,1377,421,4506,Light
680,2579,1130,397,4106,Earth
232,4550,1429,42,6021,Water
1070,3606,1450,160,5216,Dark
763,2532,1439,475,4446,Light
271,100,100,10,210,Fire
624,925,376,43,1344,Fire
1147,859,423,130,1412,Water
768,1695,2043,331,4069,Fire
501,2428,1104,344,3876,Light
1249,1805,2059,403,4267,Earth
295,623,450,260,1333,Water
1367,3650,1288,254,5192,Fire
554,1242,1916,330,3488,Fire
815,2374,1344,328,4046,Dark
1004,4000,1527,462,5989,Light
1464,1933,2142,351,4426,Earth
73,579,272,497,1348,Light
787,1462,1961,337,3760,Fire
240,4456,1571,39,6066,Dark
474,688,1173,177,2038,Dark
1439,3576,1514,447,5537,Light
1387,4080,1511,183,5774,Light
273,100,100,10,210,Light
1383,4883,1377,35,6295,Fire
788,2771,1122,321,4214,Earth
1443,855,410,238,1503,Earth
526,937,393,214,1544,Earth
816,3517,1538,446,5501,Fire
609,1054,517,209,1780,Light
404,1549,622,73,2244,Fire
853,3601,1249,152,5002,Earth
1042,3102,1604,376,5082,Fire
946,1338,762,210,2310,Water
1172,2880,1316,501,4697,Light
1486,1785,2113,411,4309,Light
19,784,483,140,1407,Dark
492,2587,1134,131,3852,Fire
1259,2220,1241,394,3855,Light
1303,2574,1132,364,4070,Earth
1361,3893,1672,398,5963,Earth
632,3197,1272,178,4647,Light
928,374,151,17,542,Fire
1295,3164,1438,448,5050,Light
721,4182,4822,1119,10123,Water
1449,2743,1667,420,4830,Fire
1069,3948,1264,182,5394,Light
498,2567,1105,155,3827,Light
6,384,214,60,658,Fire
1476,3322,1519,374,5215,Earth
972,309,158,55,522,Light
323,293,129,47,469,Earth
78,506,136,4,646,Fire
761,2809,1330,432,4571,Earth
