id,Hit Point,Attack Point,Recovery,Total,Attribute,Race
977,1687,1656,489,3832,Water,Demon
72,185,87,159,431,Light,Elf
69,584,313,430,1327,Fire,Elf
493,1880,859,373,3112,Earth,Elf
443,905,364,49,1318,Water,Beast
1024,3264,1869,476,5609,Fire,God
1192,1710,1212,1012,3934,Fire,Elf
35,1122,413,148,1683,Light,Beast
425,500,500,500,1500,Water,Material
437,3097,1257,145,4499,Earth,Beast
591,4226,1327,39,5592,Water,Dragon
539,1664,966,220,2850,Dark,God
1095,1329,2127,360,3816,Dark,Demon
1156,1356,956,682,2994,Water,Elf
625,1880,765,86,2731,Fire,Beast
1059,2757,1705,302,4764,Fire,God
559,866,1479,248,2593,Dark,Demon
844,2617,1402,396,4415,Water,God
472,753,1022,203,1978,Light,Demon
466,703,1068,191,1962,Water,Demon
134,441,246,70,757,Fire,Human
1343,2187,1221,838,4246,Earth,Elf
274,100,100,10,210,Dark,Material
927,1118,440,62,1620,Water,Beast
359,1344,769,182,2295,Dark,God
486,400,596,162,1158,Water,Demon
711,1475,2249,390,4114,Water,Demon
490,392,655,150,1197,Dark,Demon
265,100,300,0,400,Fire,Material
112,523,170,27,720,Light,Beast
329,736,387,406,1529,Water,Elf
410,2513,1100,386,3999,Earth,Human
211,1531,627,80,2238,Water,Beast
1454,944,1388,213,2545,Dark,Demon
250,300,100,20,420,Dark,Material
495,2408,1164,137,3709,Dark,Beast
1377,3540,1509,435,5484,Earth,God
400,2600,100,100,2800,Water,Material
654,1233,1665,411,3309,Light,Demon
261,600,200,1,801,Water,Material
1219,3548,1416,475,5439,Light,God
93,926,475,178,1579,Light,Human
842,2753,1424,351,4528,Fire,God
179,468,197,20,685,Fire,Beast
1083,2880,1605,460,4945,Fire,Human
307,610,495,240,1345,Dark,Elf
317,1461,582,25,2068,Dark,Dragon
937,2002,1764,348,4114,Water,Demon
418,3568,949,101,4618,Earth,Dragon
996,3122,1447,446,5015,Light,God
1318,5073,1210,39,6322,Earth,Dragon
254,600,200,40,840,Light,Material
831,460,228,70,758,Water,God
924,2497,1094,384,3975,Earth,Human
1297,2921,1806,432,5159,Fire,Human
331,851,356,379,1586,Earth,Elf
1305,2225,1377,322,3924,Dark,Human
542,2654,1351,381,4386,Water,God
704,3245,1864,200,5309,Dark,Beast
1213,3332,1401,387,5120,Earth,God
1072,2703,1134,433,4270,Light,Human
1452,1527,764,280,2571,Light,Human
628,2065,658,90,2813,Earth,Beast
1411,632,948,232,1812,Water,Demon
238,4740,1330,44,6114,Light,Dragon
1209,3012,1390,410,4812,Fire,God
1374,3501,2017,487,6005,Fire,God
1267,1863,2405,310,4578,Fire,Demon
1346,3959,1515,454,5928,Water,Machina
1144,1305,746,177,2228,Dark,God
644,4017,1469,166,5652,Light,Beast
485,2510,1354,585,4449,Dark,God
595,2014,1189,859,4062,Dark,Elf
86,284,163,55,502,Water,Human
976,2755,1476,360,4591,Fire,God
758,1315,736,211,2262,Fire,Human
354,1109,1638,340,3087,Dark,Demon
733,1289,1608,487,3384,Light,Demon
1279,1863,2323,328,4514,Fire,Demon
1137,2769,1486,433,4688,Water,God
908,2447,1266,490,4203,Light,Human
820,3571,1346,545,5462,Light,God
1043,3132,1372,384,4888,Earth,Human
129,984,787,336,2107,Dark,God
778,2325,1019,358,3702,Earth,Human
906,2749,1243,423,4415,Earth,Human
280,400,400,40,840,Water,Material
1432,1728,2323,337,4388,Water,Demon
256,1000,300,80,1380,Water,Material
565,2915,1395,158,4468,Fire,Beast
1091,2145,1240,651,4036,Water,Elf
667,8454,2699,67,11220,Fire,Dragon
158,466,168,4,638,Dark,Dragon
656,7059,3454,1088,11601,Water,Human
779,2095,1029,393,3517,Light,Human
1129,1685,2145,511,4341,Light,Demon
379,1000,300,80,1380,Water,Material
1157,1212,1724,302,3238,Fire,Demon
9,149,66,23,238,Earth,Human
175,2379,1057,274,3710,Dark,Machina
627,1017,324,45,1386,Earth,Beast
963,7624,3589,970,12183,Earth,God
1008,188,283,70,541,Fire,Demon
1496,2322,1298,340,3960,Fire,Human
1055,1064,1753,274,3091,Dark,Demon
894,2472,1455,424,4351,Fire,Human
155,394,146,20,560,Light,Beast
1446,1433,845,211,2489,Water,Human
120,1057,765,323,2145,Fire,God
1416,1293,608,199,2100,Water,God
930,412,130,18,560,Earth,Beast
745,2619,1459,384,4462,Light,Human
209,1593,794,210,2597,Dark,God
96,137,72,86,295,Water,Elf
195,1521,715,191,2427,Earth,God
1082,4428,1502,41,5971,Water,Dragon
33,257,93,34,384,Light,Beast
336,928,388,471,1787,Earth,Elf
470,812,1011,184,2007,Earth,Demon
405,1702,535,76,2313,Earth,Beast
1455,1946,2283,355,4584,Dark,Demon
734,773,1056,227,2056,Dark,Demon
342,1797,475,13,2285,Light,Dragon
664,2379,861,124,3364,Light,Beast
738,1200,800,300,2300,Dark,Material
468,725,1121,171,2017,Fire,Demon
149,500,163,4,667,Fire,Dragon
1020,2124,1893,386,4403,Water,Demon
1460,1000,454,540,1994,Light,Elf
665,2805,964,23,3792,Dark,Dragon
551,1105,582,593,2280,Water,Elf
1052,1143,1725,263,3131,Fire,Demon
1335,2357,2393,363,5113,Dark,Demon
398,600,600,60,1260,Light,Material
1133,3205,1416,442,5063,Light,God
1188,4010,2070,612,6692,Water,God
440,2694,976,188,3858,Earth,Beast
722,4314,5004,974,10292,Fire,Demon
537,1773,819,244,2836,Light,God
1123,3725,1364,0,5089,Earth,Dragon
886,1773,1842,300,3915,Earth,Demon
1342,2021,1367,802,4190,Fire,Elf
1161,1327,2120,362,3809,Dark,Demon
13,134,66,25,225,Light,Human
932,370,131,20,521,Light,Beast
568,3050,706,111,3867,Earth,Beast
1313,2755,1409,560,4724,Earth,God
3,801,440,151,1392,Water,Human
395,1328,2135,396,3859,Light,Demon
933,1165,410,64,1639,Light,Beast
172,2531,895,304,3730,Light,Machina
1442,778,477,227,1482,Fire,Human
1373,3637,1925,421,5983,Fire,God
1317,4617,1426,44,6087,Fire,Dragon
60,267,112,98,477,Earth,Elf
992,1215,607,288,2110,Light,God
41,672,217,7,896,Water,Dragon
479,2075,1365,471,3911,Fire,Human
1349,4078,1410,470,5958,Light,Machina
327,248,153,47,448,Dark,Material
223,561,300,255,1116,Fire,Elf
666,6981,2858,363,10202,Water,Beast
613,2579,1130,397,4106,Earth,Human
406,1533,541,84,2158,Light,Beast
912,2378,1349,452,4179,Water,Human
911,1223,695,232,2150,Water,Human
1332,1888,2322,479,4689,Light,Demon
248,300,100,20,420,Earth,Material
298,655,481,231,1367,Fire,Elf
1045,2886,1649,392,4927,Dark,God
1421,3883,1370,221,5474,Earth,Beast
1393,4558,1541,66,6165,Light,Dragon
452,1120,564,331,2015,Fire,Elf
1394,4454,1606,59,6119,Dark,Dragon
150,1624,488,10,2122,Fire,Dragon
945,2866,1810,373,5049,Dark,God
782,2527,1373,418,4318,Fire,Human
326,826,406,164,1396,Light,Material
519,2083,1074,551,3708,Light,God
1256,1665,1708,281,3654,Water,Demon
969,977,571,151,1699,Fire,Human
5,136,76,21,233,Fire,Human
811,2425,1223,354,4002,Water,God
1405,3808,1614,601,6023,Light,God
898,2477,1255,465,4197,Light,Human
1473,1291,734,156,2181,Fire,Human
585,522,886,166,1574,Dark,Demon
803,1630,771,192,2593,Fire,God
731,1582,1672,422,3676,Earth,Demon
325,264,130,52,446,Light,Material
868,1586,894,719,3199,Light,Elf
57,722,380,327,1429,Water,Elf
752,1302,640,244,2186,Light,Human
10,421,184,64,669,Earth,Human
1206,2803,1558,426,4787,Fire,Human
401,2163,1011,310,3484,Light,God
44,706,232,7,945,Fire,Dragon
1044,3076,1398,435,4909,Light,God
458,1562,646,248,2456,Earth,Human
1223,1711,787,146,2644,Fire,Beast
827,3420,1480,512,5412,Water,God
394,697,946,213,1856,Light,Demon
368,2781,1264,394,4439,Light,God
243,100,30,10,140,Earth,Material
130,1583,1280,530,3393,Dark,God
1316,4550,1384,68,6002,Water,Dragon
178,2319,940,123,3382,Water,Beast
1396,1200,800,300,2300,Water,Material
32,2949,952,322,4223,Earth,Beast
1404,2317,2570,407,5294,Earth,Demon
893,1271,748,218,2237,Fire,Human
915,1275,646,238,2159,Light,Human
823,3305,1579,486,5370,Dark,God
649,1099,539,212,1850,Light,Human
949,2735,1582,364,4681,Fire,God
1456,1453,843,213,2509,Fire,Human
773,1058,333,48,1439,Earth,Beast
453,1231,486,349,2066,Earth,Elf
101,488,204,244,936,Earth,Elf
720,1207,2086,418,3711,Dark,Demon
1490,3333,1524,316,5173,Fire,Beast
302,1365,989,499,2853,Earth,Elf
1294,3229,1250,503,4982,Earth,Human
166,2556,1028,263,3847,Fire,Machina
42,1778,545,15,2338,Water,Dragon
701,1200,800,300,2300,Light,Material
749,2280,1497,451,4228,Fire,Human
1258,2374,1205,370,3949,Earth,Human
489,417,555,166,1138,Light,Demon
1359,3542,1941,378,5861,Fire,God
617,100,800,100,1000,Earth,Material
1126,1567,2254,479,4300,Water,Demon
685,2504,1588,470,4562,Dark,Human
1081,4627,1382,45,6054,Water,Dragon
881,788,1029,163,1980,Water,Demon
543,1622,2215,404,4241,Fire,Demon
50,699,201,7,907,Light,Dragon
137,485,212,74,771,Earth,Human
439,2451,1134,180,3765,Fire,Beast
1236,1386,718,194,2298,Water,God
349,2497,1201,347,4045,Earth,Human
694,744,350,413,1507,Light,Elf
1431,3149,1581,392,5122,Dark,God
1085,4336,1367,203,5906,Earth,Beast
384,1200,500,100,1800,Light,Material
215,1933,486,15,2434,Earth,Dragon
136,2277,1273,372,3922,Fire,Human
578,900,600,200,1700,Dark,Material
1214,5107,1313,116,6536,Light,Dragon
562,2698,1226,382,4306,Light,God
1187,1200,800,300,2300,Water,Material
1197,2131,2604,365,5100,Fire,Demon
909,1198,763,215,2176,Dark,Human
352,1324,1553,343,3220,Earth,Demon
849,1200,800,300,2300,Earth,Material
204,3326,1499,392,5217,Fire,God
1220,3207,1705,403,5315,Dark,God
684,2184,1348,393,3925,Dark,Human
1403,2600,100,100,2800,Water,Material
1092,2670,1550,347,4567,Fire,God
30,566,187,61,814,Earth,Beast
958,2576,1275,347,4198,Earth,God
852,3321,1419,135,4875,Fire,Beast
124,1869,1073,535,3477,Earth,God
284,400,400,40,840,Dark,Material
744,912,379,46,1337,Water,Beast
304,649,419,267,1335,Light,Elf
386,70,600,0,670,Dark,Material
1104,1724,2429,330,4483,Fire,Demon
671,1525,2167,340,4032,Dark,Demon
1062,1131,555,212,1898,Light,Human
1365,3296,1995,394,5685,Dark,God
687,2608,1574,420,4602,Fire,Human
1286,1071,596,205,1872,Water,Human
412,2128,1314,383,3825,Dark,Human
1064,1305,746,177,2228,Dark,God
615,2184,1348,393,3925,Dark,Human
598,1405,697,156,2258,Fire,Human
874,736,346,296,1378,Light,Elf
89,934,546,155,1635,Fire,Human
817,3517,1538,446,5501,Fire,God
871,707,372,288,1367,Water,Elf
1017,4505,1766,403,6674,Light,God
1100,1783,2217,362,4362,Earth,Demon
1078,1200,800,300,2300,Dark,Material
527,378,177,104,659,Light,Elf
696,2589,1113,134,3836,Water,Beast
347,2486,1390,400,4276,Fire,Human
114,493,200,24,717,Dark,Beast
712,1531,2377,344,4252,Fire,Demon
710,1272,643,286,2201,Dark,Beast
824,3802,1327,485,5614,Earth,God
550,283,477,96,856,Dark,Demon
506,3387,1502,473,5362,Water,God
997,1200,800,300,2300,Light,Material
1075,2002,1235,336,3573,Dark,Human
237,2438,687,23,3148,Light,Dragon
289,2788,1537,165,4490,Dark,Beast
424,300,300,300,900,Fire,Material
20,1843,1137,337,3317,Dark,Human
777,1323,1729,290,3342,Fire,Demon
1162,2625,1612,427,4664,Dark,Human
910,2329,1483,419,4231,Dark,Human
88,299,175,49,523,Fire,Human
1033,1303,806,109,2218,Fire,Human
236,5262,1315,40,6617,Earth,Dragon
429,1200,800,300,2300,Light,Material
1358,3364,1923,391,5678,Fire,God
197,1370,723,210,2303,Light,God
341,1894,470,12,2376,Earth,Dragon
1433,3259,1601,337,5197,Fire,God
801,1549,720,216,2485,Water,God
1402,2000,50,50,2100,Water,Material
203,1711,773,201,2685,Fire,God
634,1749,786,90,2625,Dark,Beast
71,642,269,452,1363,Earth,Elf
846,2760,1903,40,4703,Fire,Dragon
931,1293,406,58,1757,Earth,Beast
579,4230,1668,379,6277,Light,God
268,1200,200,200,1600,Earth,Material
1205,2533,1626,401,4560,Dark,Human
1363,3506,1801,437,5744,Light,God
645,2916,1666,378,4960,Dark,God
25,260,106,29,395,Fire,Beast
913,1415,639,218,2272,Earth,Human
1247,2208,1010,922,4140,Water,Elf
202,3161,1402,442,5005,Water,God
784,2396,1219,344,3959,Water,God
279,200,200,20,420,Dark,Material
348,1679,735,263,2677,Earth,Human
719,1512,1861,464,3837,Light,Demon
1494,1200,800,300,2300,Light,Material
1422,1114,549,216,1879,Light,Human
294,279,201,116,596,Water,Elf
1401,1500,25,25,1550,Water,Material
1109,741,1186,141,2068,Dark,Demon
186,1510,540,81,2131,Light,Beast
528,844,396,236,1476,Light,Elf
1283,2805,1418,528,4751,Light,Human
181,2440,1005,109,3554,Fire,Beast
1372,3416,1936,564,5916,Water,God
301,720,414,243,1377,Earth,Elf
1124,2141,1503,208,3852,Light,Demon
1251,2730,1409,515,4654,Light,Human
699,1231,796,699,2726,Light,Elf
162,1303,517,167,1987,Water,Machina
669,7272,2660,373,10305,Light,Beast
556,2993,976,126,4095,Earth,Beast
333,720,425,375,1520,Dark,Elf
496,1954,1392,431,3777,Fire,Human
1327,2413,2270,391,5074,Water,Demon
1140,1540,625,178,2343,Earth,God
139,2502,1096,390,3988,Earth,Human
1079,3428,1619,314,5361,Dark,God
245,100,30,10,140,Dark,Material
661,2285,925,121,3331,Water,Beast
1175,2894,1786,420,5100,Dark,Human
1107,795,1086,189,2070,Light,Demon
1475,1425,652,160,2237,Earth,Human
978,2535,1448,344,4327,Dark,God
456,1352,701,266,2319,Water,Human
135,1415,791,235,2441,Fire,Human
1380,3934,1611,168,5713,Water,Beast
959,2342,1335,385,4062,Light,God
572,3625,1273,115,5013,Fire,Dragon
1420,1535,543,87,2165,Earth,Beast
373,1591,646,185,2422,Earth,God
1186,3127,1647,220,4994,Dark,Beast
374,3092,1253,359,4704,Earth,God
1347,4019,1620,403,6042,Fire,Machina
1,129,71,24,224,Water,Human
253,600,200,40,840,Earth,Material
1355,1668,2633,326,4627,Dark,Demon
950,1546,702,197,2445,Earth,God
769,2520,1088,232,3840,Light,Beast
1076,1200,800,300,2300,Water,Material
802,3011,1399,421,4831,Water,God
962,6964,4077,896,11937,Fire,God
187,2416,874,126,3416,Light,Beast
764,1231,803,221,2255,Dark,Human
575,3373,1308,120,4801,Dark,Dragon
481,2540,1252,632,4424,Water,God
663,2144,938,335,3417,Earth,Human
177,1450,581,79,2110,Water,Beast
1037,1291,702,127,2120,Light,Human
1153,895,393,134,1422,Light,God
705,2238,1667,320,4225,Fire,Human
108,529,195,23,747,Fire,Beast
370,2609,1490,355,4454,Dark,God
427,600,600,60,1260,Fire,Material
883,821,1089,144,2054,Fire,Demon
549,545,267,105,917,Light,Human
951,3005,1362,383,4750,Earth,God
806,3481,1288,394,5163,Earth,God
378,2670,1359,383,4412,Water,God
1207,3027,1407,470,4904,Earth,Human
639,1141,1548,353,3042,Light,Demon
1089,2215,1254,909,4378,Dark,Elf
843,1888,1580,405,3873,Earth,Demon
196,2955,1389,373,4717,Earth,God
724,4207,4687,1194,10088,Light,Demon
277,200,200,20,420,Earth,Material
100,159,66,80,305,Earth,Elf
1025,3961,1529,464,5954,Earth,God
1039,1213,829,114,2156,Dark,Human
1382,4908,1364,35,6307,Fire,Dragon
1068,4175,1201,158,5534,Earth,Dragon
1329,2458,2346,345,5149,Fire,Demon
563,1848,1493,418,3759,Light,Demon
525,419,176,95,690,Earth,Elf
319,253,139,51,443,Water,Material
389,1230,2193,386,3809,Water,Demon
1225,1816,714,158,2688,Earth,Beast
529,356,210,95,661,Dark,Elf
275,200,200,20,420,Water,Material
993,2529,1259,601,4389,Light,God
205,1881,665,212,2758,Earth,God
138,1556,681,248,2485,Earth,Human
1060,1540,625,178,2343,Earth,God
942,3080,1760,358,5198,Fire,God
638,1266,1531,321,3118,Earth,Demon
1426,1446,656,172,2274,Fire,God
1339,2914,1432,574,4920,Light,Human
834,1516,759,195,2470,Fire,God
670,7868,2774,69,10711,Dark,Dragon
80,556,117,4,677,Earth,Dragon
1410,3232,1645,303,5180,Dark,Beast
438,2330,1060,202,3592,Water,Beast
457,1422,749,237,2408,Fire,Human
227,555,261,295,1111,Light,Elf
235,2706,679,21,3406,Earth,Dragon
1360,3697,1656,412,5765,Earth,God
571,3618,1190,129,4937,Water,Dragon
1224,3328,1528,285,5141,Fire,Beast
1038,3000,1298,294,4592,Light,Beast
697,1242,1708,330,3280,Fire,Demon
350,1169,1597,367,3133,Water,Demon
234,4788,1528,38,6354,Fire,Dragon
163,2430,961,296,3687,Water,Machina
1284,762,1000,124,1886,Dark,Demon
1047,2624,1467,422,4513,Fire,Human
750,1289,664,244,2197,Earth,Human
682,2324,1142,436,3902,Light,Human
1274,591,234,121,946,Light,Human
1369,3643,1120,300,5063,Light,Machina
1366,3497,1209,292,4998,Water,Machina
1243,3418,1235,412,5065,Light,God
97,422,222,261,905,Water,Elf
91,1027,470,163,1660,Earth,Human
600,1544,600,164,2308,Earth,Human
541,1200,500,100,1800,Fire,Material
966,296,170,54,520,Water,Human
252,600,200,40,840,Fire,Material
81,1746,360,10,2116,Earth,Dragon
727,1334,1770,441,3545,Water,Demon
476,1443,897,709,3049,Water,Elf
794,2422,608,19,3049,Earth,Dragon
51,1852,507,16,2375,Light,Dragon
1252,2775,1655,365,4795,Dark,God
943,3385,1516,376,5277,Earth,God
1142,1388,631,196,2215,Light,God
309,1492,529,26,2047,Water,Dragon
11,925,405,141,1471,Earth,Human
1185,4802,1578,45,6425,Dark,Dragon
1077,2832,1612,372,4816,Fire,God
487,421,637,144,1202,Fire,Demon
602,1392,607,180,2179,Light,Human
557,2014,919,284,3217,Light,God
1148,484,239,64,787,Fire,God
901,1223,695,232,2150,Water,Human
1135,4121,2071,501,6693,Dark,God
1436,3061,1616,351,5028,Dark,God
239,2291,811,20,3122,Dark,Dragon
36,2416,874,321,3611,Light,Beast
780,1969,1215,354,3538,Dark,Human
1228,4300,1454,63,5817,Light,Dragon
536,2805,1229,324,4358,Earth,Human
346,1528,854,250,2632,Fire,Human
926,356,141,20,517,Water,Beast
23,1354,431,39,1824,Water,Dragon
513,3292,1073,329,4694,Earth,Beast
623,2996,1393,173,4562,Water,Beast
614,2324,1142,436,3902,Light,Human
1348,4417,1395,425,6237,Earth,Machina
895,1443,699,226,2368,Earth,Human
1493,4134,1222,30,5386,Earth,Dragon
65,707,418,303,1428,Dark,Elf
792,2204,706,18,2928,Fire,Dragon
1468,2367,1310,321,3998,Fire,Human
310,2440,898,50,3388,Water,Dragon
344,1452,798,282,2532,Water,Human
1088,3201,1506,500,5207,Light,God
515,2535,1164,297,3996,Dark,Beast
688,2866,1356,441,4663,Earth,Human
1479,1006,585,304,1895,Dark,Elf
1198,1805,2202,402,4409,Light,Demon
1132,1456,2317,378,4151,Dark,Demon
522,810,427,230,1467,Water,Elf
552,1477,777,800,3054,Water,Elf
1018,1434,2066,380,3880,Fire,Demon
994,1058,738,256,2052,Dark,God
510,3316,1651,438,5405,Dark,God
433,2759,1380,175,4314,Water,Beast
70,206,86,144,436,Earth,Elf
214,3591,1146,28,4765,Fire,Dragon
242,100,30,10,140,Fire,Material
366,2779,1263,394,4436,Light,God
772,948,474,122,1544,Fire,Dragon
288,3144,1302,213,4659,Light,Beast
269,2000,300,300,2600,Earth,Material
1034,3029,1492,254,4775,Fire,Beast
1181,4758,1454,133,6345,Water,Dragon
1056,1086,597,206,1889,Water,Human
1427,3372,1529,401,5302,Fire,God
1217,3410,1616,396,5422,Fire,God
730,913,885,229,2027,Earth,Demon
1058,1402,726,170,2298,Fire,God
430,1200,800,300,2300,Light,Material
132,1345,740,265,2350,Water,Human
461,1611,645,87,2343,Water,Beast
1074,2793,1603,390,4786,Dark,Human
300,322,186,108,616,Earth,Elf
1304,2401,1150,406,3957,Light,Human
1237,3016,1561,425,5002,Water,God
532,2426,1334,347,4107,Water,Human
436,1385,562,65,2012,Earth,Beast
597,2595,1267,342,4204,Water,Human
1244,884,954,119,1957,Dark,Demon
948,1407,815,187,2409,Fire,God
1071,2119,1223,300,3642,Dark,Human
840,1411,779,203,2393,Dark,God
74,175,103,143,421,Dark,Elf
995,2200,1534,535,4269,Dark,God
164,452,180,42,674,Fire,Machina
983,2616,1511,136,4263,Fire,Beast
855,3192,1453,141,4786,Dark,Beast
192,2555,1508,398,4461,Water,God
1345,1895,1367,814,4076,Dark,Elf
524,853,456,204,1513,Fire,Elf
185,464,172,23,659,Light,Beast
152,358,157,54,569,Earth,Human
422,3082,1155,102,4339,Dark,Dragon
599,2731,1355,304,4390,Fire,Human
1049,3231,1308,200,4739,Light,Beast
747,2405,1462,481,4348,Water,Human
318,2390,986,46,3422,Dark,Dragon
54,1740,599,14,2353,Dark,Dragon
1399,2600,100,100,2800,Fire,Material
1353,1980,2382,390,4752,Earth,Demon
1232,1628,1125,534,3287,Fire,Elf
1007,338,503,136,977,Water,Demon
92,296,152,57,505,Light,Human
1406,3349,1486,354,5189,Water,Beast
1409,3408,1393,388,5189,Light,Beast
889,1233,799,185,2217,Dark,God
590,3435,1392,399,5226,Earth,God
446,943,338,50,1331,Light,Beast
4,1881,1035,364,3280,Water,Human
1463,2789,1625,400,4814,Fire,Human
936,1200,800,300,2300,Dark,Material
312,2568,959,44,3571,Fire,Dragon
224,2464,1377,397,4238,Fire,Human
1497,2799,1507,298,4604,Dark,God
407,1441,539,75,2055,Dark,Beast
330,774,414,360,1548,Fire,Elf
774,765,375,152,1292,Light,Human
1248,808,923,178,1909,Earth,Demon
1145,2775,1653,330,4758,Dark,God
1234,3140,1032,139,4311,Light,Beast
1272,581,268,103,952,Fire,Human
1319,4740,1288,58,6086,Light,Dragon
866,1760,884,655,3299,Earth,Elf
702,1200,800,300,2300,Dark,Material
918,1830,1376,639,3845,Dark,Elf
85,1478,429,10,1917,Dark,Dragon
1344,2023,1197,913,4133,Light,Elf
837,480,212,71,763,Light,God
194,2689,1612,353,4654,Fire,God
15,834,410,156,1400,Light,Human
190,2271,1033,114,3418,Dark,Beast
982,1190,689,61,1940,Fire,Beast
396,637,1086,186,1909,Dark,Demon
876,1849,1123,850,3822,Light,Elf
939,2386,1497,448,4331,Light,Human
516,519,205,25,749,Fire,Beast
692,751,402,357,1510,Fire,Elf
267,500,100,100,700,Earth,Material
838,1501,660,225,2386,Light,God
601,3001,1167,320,4488,Earth,Human
46,3672,1142,26,4840,Fire,Dragon
1180,2056,1304,266,3626,Dark,Human
1484,2610,1578,492,4680,Fire,Human
760,1445,684,222,2351,Earth,Human
220,2535,1448,344,4327,Dark,God
1291,2820,1707,410,4937,Dark,Human
465,1577,709,81,2367,Dark,Beast
836,1667,653,205,2525,Earth,God
444,952,389,43,1384,Fire,Beast
1417,3017,1416,466,4899,Water,God
320,792,436,159,1387,Water,Material
795,4904,1244,37,6185,Earth,Dragon
43,3489,1068,30,4587,Water,Dragon
1073,2376,1530,379,4285,Dark,Human
1183,5120,1315,106,6541,Earth,Dragon
1333,2479,2192,426,5097,Light,Demon
1118,1103,280,7,1390,Light,Dragon
1196,2315,1126,807,4248,Earth,Elf
357,1444,748,174,2366,Fire,God
748,1174,771,232,2177,Fire,Human
905,1415,639,218,2272,Earth,Human
756,1287,769,227,2283,Water,God
1146,460,224,71,755,Water,God
1430,1350,679,168,2197,Dark,God
191,1315,777,205,2297,Water,God
217,1594,584,82,2260,Light,Beast
851,3262,1349,192,4803,Water,Beast
1136,1332,679,191,2202,Water,God
683,2652,1360,520,4532,Light,Human
1246,947,433,394,1774,Water,Elf
233,2462,789,20,3271,Fire,Dragon
767,2650,1231,408,4289,Earth,Human
790,2095,660,20,2775,Water,Dragon
497,1319,569,80,1968,Light,Beast
494,2562,1036,153,3751,Light,Beast
199,1287,854,189,2330,Dark,God
1429,3611,1412,355,5378,Earth,God
1330,1965,2396,418,4779,Earth,Demon
659,7597,3128,1098,11823,Light,Human
402,965,1645,286,2896,Dark,Demon
1477,1213,722,180,2115,Light,Human
1200,1000,1000,1000,3000,Water,Material
1226,3531,1386,309,5226,Earth,Beast
726,790,961,246,1997,Water,Demon
1168,2712,1570,400,4682,Fire,Human
483,2835,1152,591,4578,Earth,God
914,2749,1243,423,4415,Earth,Human
1418,1381,635,158,2174,Fire,God
751,2506,1289,475,4270,Earth,Human
58,243,130,92,465,Fire,Elf
1325,3284,1635,210,5129,Dark,Beast
345,2363,1300,449,4112,Water,Human
841,2617,1331,396,4344,Water,God
64,226,134,97,457,Dark,Elf
1051,1086,1685,296,3067,Water,Demon
1066,3754,1345,176,5275,Water,Dragon
169,2809,885,278,3972,Earth,Machina
1131,3224,1427,200,4851,Earth,Beast
723,4560,4660,1102,10322,Earth,Demon
1211,2708,1237,390,4335,Light,God
1392,3743,1469,327,5539,Earth,Beast
832,1441,710,219,2370,Water,God
1152,479,208,73,760,Light,God
84,471,140,4,615,Dark,Dragon
193,1384,831,181,2396,Fire,God
941,2927,1646,403,4976,Water,God
1021,3556,1577,496,5629,Water,God
482,2502,1318,562,4382,Fire,God
364,2779,1263,394,4436,Light,God
40,2271,1033,289,3593,Dark,Beast
626,3006,1439,135,4580,Fire,Beast
1134,2952,1494,421,4867,Water,God
1167,2850,1567,566,4983,Water,Human
28,2684,1105,305,4094,Fire,Beast
62,241,114,107,462,Light,Elf
810,2948,1537,390,4875,Dark,God
21,309,94,7,410,Water,Dragon
793,4353,1514,36,5903,Fire,Dragon
1414,658,882,239,1779,Light,Demon
715,1447,2462,362,4271,Dark,Demon
648,1220,534,193,1947,Earth,Human
1273,638,231,108,977,Earth,Human
285,2643,1413,725,4781,Fire,Elf
1425,2942,1651,351,4944,Dark,God
22,616,198,18,832,Water,Dragon
1385,5194,1220,37,6451,Earth,Dragon
783,1200,800,300,2300,Fire,Material
1474,3010,1757,364,5131,Fire,Human
109,1174,437,50,1661,Fire,Beast
1027,3738,1545,531,5814,Light,God
737,1440,1968,452,3860,Water,Demon
1498,4218,1347,134,5699,Water,Dragon
606,1012,556,203,1771,Water,Human
1471,1215,687,175,2077,Water,Human
1106,1895,2279,368,4542,Earth,Demon
892,2349,1360,477,4186,Water,Human
759,2555,1429,411,4395,Fire,Human
847,2357,1518,453,4328,Light,God
991,2634,1328,558,4520,Earth,God
897,1275,646,238,2159,Light,Human
255,600,200,40,840,Dark,Material
1440,3368,1732,380,5480,Dark,God
545,2511,1174,531,4216,Water,Human
1193,1872,1050,1060,3982,Earth,Elf
276,200,200,20,420,Fire,Material
1424,1262,709,150,2121,Dark,God
1063,2690,1322,529,4541,Light,Human
464,1678,600,90,2368,Light,Beast
652,3616,1125,25,4766,Fire,Dragon
260,1000,300,80,1380,Dark,Material
725,3809,5210,1002,10021,Dark,Demon
812,2551,1308,315,4174,Fire,God
377,1374,700,197,2271,Water,God
1263,3383,1426,405,5214,Earth,God
970,343,157,51,551,Earth,Human
713,1691,2165,376,4232,Earth,Demon
448,2798,1062,138,3998,Earth,Beast
826,3422,1480,512,5414,Water,God
1320,4376,1500,46,5922,Dark,Dragon
1309,4520,2130,440,7090,Dark,God
1098,2426,1625,422,4473,Water,Human
184,2681,865,115,3661,Earth,Beast
971,1073,492,159,1724,Earth,Human
740,2565,1314,458,4337,Light,God
1257,1743,1768,222,3733,Fire,Demon
1155,841,465,121,1427,Dark,God
508,3772,1455,442,5669,Earth,God
981,2759,1380,175,4314,Water,Beast
850,7503,1877,0,9380,Earth,Dragon
819,3307,1581,481,5369,Dark,God
1221,1266,546,422,2234,Water,Elf
1028,3259,1712,572,5543,Light,God
1308,4036,4815,856,9707,Fire,Demon
67,556,293,484,1333,Water,Elf
619,894,416,43,1353,Dark,Beast
1016,1200,800,300,2300,Light,Material
546,646,260,35,941,Water,Beast
1195,2220,1252,870,4342,Dark,Elf
1053,1201,1651,284,3136,Earth,Demon
577,600,300,100,1000,Water,Material
872,744,398,256,1398,Fire,Elf
353,1217,1519,389,3125,Light,Demon
1412,664,1014,207,1885,Fire,Demon
1178,2274,1055,354,3683,Earth,Human
1336,2771,1524,553,4848,Water,Human
512,2996,1247,314,4557,Fire,Beast
328,776,479,147,1402,Dark,Material
360,2612,1492,355,4459,Dark,God
743,2616,1189,403,4208,Light,God
127,1684,1084,588,3356,Light,God
564,5299,1424,39,6762,Light,Dragon
938,2036,1886,309,4231,Fire,Demon
668,5893,2581,907,9381,Earth,Human
509,3560,1472,505,5537,Light,God
925,2250,1106,422,3778,Light,Human
200,2503,1657,369,4529,Dark,God
640,1072,1828,318,3218,Dark,Demon
555,2231,731,93,3055,Earth,Beast
1171,3330,1426,507,5263,Earth,Human
161,429,169,47,645,Water,Machina
421,1517,596,46,2159,Dark,Dragon
1203,2912,1354,452,4718,Earth,Human
1296,2726,1522,490,4738,Dark,Human
417,1757,491,45,2293,Earth,Dragon
1435,3360,1486,440,5286,Light,God
153,1149,503,183,1835,Earth,Human
1164,2735,1560,438,4733,Water,Human
99,444,237,232,913,Fire,Elf
916,2477,1255,465,4197,Light,Human
111,1289,377,53,1719,Earth,Beast
1000,2600,100,100,2800,Light,Material
957,2344,1480,330,4154,Fire,God
1314,2511,1444,613,4568,Light,God
1029,3482,1734,460,5676,Dark,God
833,484,244,62,790,Fire,God
1120,1036,330,6,1372,Dark,Dragon
754,1225,787,220,2232,Dark,Human
372,3090,1252,359,4701,Earth,God
1190,3503,1854,406,5763,Fire,God
503,1200,800,300,2300,Water,Material
800,2000,50,50,2100,Water,Material
1036,3330,1285,267,4882,Earth,Beast
1323,3843,1393,196,5432,Earth,Beast
154,1849,810,288,2947,Earth,Human
95,870,561,161,1592,Dark,Human
947,2599,1479,410,4488,Water,God
1151,994,389,122,1505,Earth,God
34,510,189,68,767,Light,Beast
807,1614,671,223,2508,Light,God
1379,3093,1843,367,5303,Dark,God
569,2748,714,122,3584,Light,Beast
681,2870,1312,461,4643,Earth,Human
388,651,988,202,1841,Water,Demon
610,990,612,189,1791,Dark,Human
1378,3373,1522,476,5371,Light,God
964,7143,3665,1068,11876,Light,God
1491,2216,1353,816,4385,Water,Elf
1125,3190,1593,22,4805,Dark,Dragon
1270,2770,1732,381,4883,Dark,God
1300,2016,129,205,2350,Water,Material
434,1190,689,61,1940,Fire,Beast
830,1614,2102,473,4189,Earth,Demon
7,842,470,135,1447,Fire,Human
517,646,260,35,941,Water,Beast
1472,2836,1601,409,4846,Water,Human
157,2053,744,107,2904,Light,Beast
700,1179,1773,343,3295,Dark,Demon
796,2182,614,20,2816,Light,Dragon
159,1511,502,11,2024,Dark,Dragon
766,1363,633,209,2205,Earth,Human
1130,1740,2315,386,4441,Dark,Demon
1362,3332,1786,452,5570,Light,God
1428,1548,606,152,2306,Earth,God
263,1000,500,3,1503,Water,Material
454,1108,491,383,1982,Light,Elf
167,497,156,44,697,Earth,Machina
535,1814,794,203,2811,Earth,Human
1281,3045,1354,495,4894,Earth,Human
1280,1205,536,196,1937,Earth,Human
408,2173,1195,413,3781,Water,Human
1003,4440,1540,420,6400,Earth,Human
1390,2607,1124,872,4603,Water,Elf
1093,2368,1165,626,4159,Earth,Elf
864,1601,1027,622,3250,Fire,Elf
303,290,187,119,596,Light,Elf
362,2612,1492,355,4459,Dark,God
1208,2604,1679,412,4695,Dark,Human
1229,2160,782,29,2971,Dark,Dragon
1485,709,988,164,1861,Light,Demon
105,412,244,241,897,Dark,Elf
1222,2460,1061,822,4343,Water,Elf
1165,1750,2205,330,4285,Dark,Demon
1041,2709,1490,411,4610,Water,Human
460,1323,771,247,2341,Dark,Human
90,328,150,52,530,Earth,Human
376,2671,1359,383,4413,Water,God
165,1372,554,149,2075,Fire,Machina
988,1121,726,252,2099,Fire,God
1154,450,245,66,761,Dark,God
732,823,894,252,1969,Light,Demon
1097,2416,1485,601,4502,Dark,Elf
757,2501,1494,442,4437,Water,God
603,2704,1179,352,4235,Light,Human
247,300,100,20,420,Fire,Material
935,1094,484,58,1636,Dark,Beast
272,100,100,10,210,Earth,Material
762,1303,740,244,2287,Light,Human
867,1034,583,453,2070,Light,Elf
1340,2890,1790,384,5064,Dark,God
415,1631,580,43,2254,Fire,Dragon
900,2300,1495,441,4236,Dark,Human
55,3417,1174,28,4619,Dark,Dragon
1166,2600,1430,517,4547,Water,Human
1423,2814,1387,547,4748,Light,Human
956,2228,1384,371,3983,Water,God
781,1398,1759,387,3544,Dark,Demon
282,400,400,40,840,Earth,Material
119,329,245,96,670,Fire,God
618,2662,1520,362,4544,Dark,God
637,1152,1779,305,3236,Fire,Demon
675,1200,800,300,2300,Dark,Material
1350,3787,1752,390,5929,Dark,Machina
1023,3742,1686,442,5870,Fire,God
890,2396,1562,362,4320,Dark,God
79,1589,418,9,2016,Fire,Dragon
1239,3209,1651,314,5174,Fire,God
879,1055,349,44,1448,Earth,Beast
392,773,936,194,1903,Earth,Demon
1191,2550,1055,890,4495,Water,Elf
1298,2795,1374,485,4654,Light,Human
677,2581,1425,493,4499,Water,Human
616,2423,1496,436,4355,Dark,Human
1408,3782,1346,302,5430,Earth,Beast
1173,3156,1441,549,5146,Light,Human
140,437,214,80,731,Light,Human
315,1554,493,28,2075,Light,Dragon
382,1000,300,80,1380,Light,Material
321,266,149,45,460,Fire,Material
570,2583,842,111,3536,Dark,Beast
122,362,211,100,673,Earth,God
1011,390,463,127,980,Earth,Demon
213,1847,591,15,2453,Fire,Dragon
642,4856,1310,32,6198,Fire,Dragon
884,1595,2113,282,3990,Fire,Demon
87,888,510,174,1572,Water,Human
1121,3245,1417,113,4775,Water,Dragon
1462,2689,1506,497,4692,Water,Human
505,1200,800,300,2300,Fire,Material
299,1242,1133,480,2855,Fire,Elf
1176,2008,1140,379,3527,Water,Human
1019,2039,1224,626,3889,Water,Elf
332,766,360,417,1543,Light,Elf
863,1044,670,391,2105,Fire,Elf
1469,1492,1753,309,3554,Earth,Demon
142,2254,1107,429,3790,Light,Human
586,1458,1613,333,3404,Water,Demon
118,1617,1165,572,3354,Water,God
198,2662,1403,409,4474,Light,God
77,1510,390,10,1910,Water,Dragon
643,5187,1128,35,6350,Earth,Dragon
1357,3366,1816,426,5608,Water,God
960,2181,1521,344,4046,Dark,God
1127,1640,2358,395,4393,Fire,Demon
1012,112,151,43,306,Light,Demon
1398,1200,800,300,2300,Light,Material
954,1310,838,195,2343,Dark,God
160,2420,831,20,3271,Dark,Dragon
1231,3015,1109,126,4250,Water,Beast
1457,2797,1638,415,4850,Fire,Human
835,533,210,64,807,Earth,God
409,2286,1278,368,3932,Fire,Human
1271,552,251,122,925,Water,Human
1461,1943,882,1203,4028,Light,Elf
1242,1599,578,192,2369,Light,God
176,445,184,23,652,Water,Beast
1265,2921,1682,390,4993,Dark,God
1102,1651,2362,396,4409,Water,Demon
592,2686,1501,431,4618,Fire,Human
355,1444,748,174,2366,Fire,God
447,887,400,46,1333,Dark,Beast
449,3290,1606,3,4899,Fire,Dragon
143,410,253,72,735,Dark,Human
1150,532,206,66,804,Earth,God
1103,807,1138,153,2098,Fire,Demon
534,2765,1430,335,4530,Fire,God
1230,4201,1514,56,5771,Dark,Dragon
1169,2971,1721,438,5130,Fire,Human
573,3984,1096,121,5201,Earth,Dragon
94,278,179,52,509,Dark,Human
337,836,393,518,1747,Light,Elf
12,2176,953,340,3469,Earth,Human
904,2367,1483,408,4258,Fire,Human
706,1299,584,308,2191,Water,Beast
785,2649,1348,380,4377,Water,God
1080,2751,1263,439,4453,Light,God
854,3342,1260,221,4823,Light,Beast
1026,3455,1694,501,5650,Earth,God
1400,2016,729,802,3547,Water,Material
1407,3323,1590,300,5213,Fire,Beast
979,5511,1509,51,7071,Light,Dragon
786,1149,1774,304,3227,Fire,Demon
531,1569,863,218,2650,Water,Human
1434,3366,1302,449,5117,Earth,Human
739,4259,1995,352,6606,Dark,God
875,692,408,266,1366,Dark,Elf
1111,569,155,3,727,Water,Dragon
484,2603,1165,649,4417,Light,God
121,1701,1246,509,3456,Fire,God
917,2582,1267,426,4275,Earth,Human
1009,355,537,121,1013,Fire,Demon
1255,3346,1537,254,5137,Dark,Beast
49,4036,983,28,5047,Earth,Dragon
1099,1313,2083,295,3691,Dark,Demon
593,4011,1308,168,5487,Earth,Beast
1182,4595,1556,118,6269,Fire,Dragon
113,1162,381,58,1601,Light,Beast
208,3293,1305,453,5051,Light,God
921,2160,1187,411,3758,Water,Human
1090,2353,1407,786,4546,Dark,Elf
1240,1548,640,172,2360,Earth,God
1438,3048,1269,359,4676,Light,God
676,2231,1227,424,3882,Water,Human
339,1725,510,12,2247,Water,Dragon
1276,1118,609,220,1947,Water,Human
445,1047,335,46,1428,Earth,Beast
716,1391,1914,460,3765,Water,Demon
334,802,422,505,1729,Water,Elf
630,929,331,50,1310,Light,Beast
1035,1433,695,116,2244,Earth,Human
385,50,300,0,350,Dark,Material
1277,2825,1538,558,4921,Water,Human
717,1445,1994,398,3837,Fire,Demon
965,6550,4181,956,11687,Dark,God
1141,3178,1355,390,4923,Earth,God
1163,2753,1415,479,4647,Light,Human
588,2898,1318,410,4626,Light,God
324,916,402,150,1468,Earth,Material
973,967,496,174,1637,Light,Human
76,482,127,4,613,Water,Dragon
865,1147,577,412,2136,Earth,Elf
1250,1221,631,229,2081,Light,Human
423,100,100,100,300,Earth,Material
672,444,689,107,1240,Fire,Demon
1264,3205,1465,435,5105,Light,God
1437,2787,1462,506,4755,Water,Human
538,2743,1248,389,4380,Light,God
882,1531,1996,321,3848,Water,Demon
888,2835,1289,401,4525,Light,God
1467,3066,1365,387,4818,Water,Beast
633,862,386,44,1292,Dark,Beast
1290,1116,676,162,1954,Dark,Human
313,1724,487,25,2236,Earth,Dragon
1450,1597,726,224,2547,Earth,Human
1488,3132,1385,495,5012,Earth,Human
1262,3104,1616,375,5095,Fire,God
755,2380,1530,429,4339,Dark,Human
1110,1582,2531,304,4417,Dark,Demon
1338,3521,1470,396,5387,Earth,God
189,1420,638,73,2131,Dark,Beast
1268,2040,2258,345,4643,Earth,Demon
170,447,157,48,652,Light,Machina
146,378,156,19,553,Water,Beast
1096,2395,1200,608,4203,Earth,Elf
467,1274,1936,352,3562,Water,Demon
1174,2640,1630,384,4654,Dark,Human
929,1176,471,55,1702,Fire,Beast
1050,1473,1898,356,3727,Fire,Demon
999,2600,100,100,2800,Earth,Material
27,1133,475,128,1736,Fire,Beast
789,3063,1241,355,4659,Earth,God
735,1518,1858,327,3703,Dark,Demon
